code:   pin
0   :   1
1   :   2
2   :   3
3   :   0
4   :   4
5   :   7  
6   :   5
7   :   6
